1111111111111111111111111111111111
1E0000V0000V000C00000C0V0000000001
10100101001000001V1001000000010101
101001V0101010100010V1000000010101
1P00V0000C00C000V0000000V0000000C1
1111111111111111111111111111111111