11111111111111
1CE0C0C0C00001
10000000E00001
1P000000000001
10000E00000001
10000000000001
11111111111111
